|--------------------------------------------------------------------------------------------------|
|##################################################################################################|
|####               ######  ################              #############                       #####|
|###                 ####       ###########                   #######                          ####|
|##                  ###          ########                      ####                            ###|
|##                  ####           ####                         ###                             ##|
|##                  ####           ####                         ###                             ##|
|##                  #####         ######                        ###                              #|
|#                   #####          #####                        ###                              #|
|##                  ####           #####                        ##                ####           #|
|####                ####           ####                         ##               ##########      #|
|#####              ####           #####                         ##             ###   ## # #     ##|
|######            ####             #####                        ##            ###       ##      ##|
|######            ###               #####                       ##            ##         #      ##|
|#######          ###                # ####                       #           ##          #      ##|
|#######          ###                   #####                                 ##          #      ##|
|#######        ####            ##       ####                                  #          #      ##|
|#######        ###           ####        ####                                 #                 ##|
|#######       ###           ####          ###                                 #                 ##|
|######        ###          ####           ##                                 ##                 ##|
|######                   #####           ###                                 ##                 ##|
|######                   ####            ##                                   #                 ##|
|#####                   ####            ###                                   ##      ####      ##|
|#####                  ####            ############                            # ########       ##|
|####                   ###           ##################                      #######            ##|
|###                                 ####       #########         #                              ##|
|###                           #    ####                         ##                              ##|
|###                           ##  ####                          ##                              ##|
|###                           #######                           ##                              ##|
|##                           #######                            ##               #             ###|
|##                           ######                             ##        #     ##            ####|
|##                           ###                                ##       ###   ##           ######|
|##                ##        ##               #######            ##       #### ##           #######|
|#                 ###                     ##############        ##       ######            #######|
|#                 ###                    ################       ##        #####           ########|
|#                 ####                  ###      ########       ##         ######        #########|
|#                #####                 ###        #######       ##         ######       ##########|
|#                #####                ###       #########       ##        ######        ##########|
|#                #####               ###                        ##       ###   #        ##########|
|#               #######              ###                                ###            ###########|
|#               #######              ###                               ###             ###########|
|#               #######              ###                              ###             ############|
|#               ########             ###                             ###             #####   #####|
|#               #########           ####                              ###           #####      ###|
|#               #########           #####                     #         ###         ####        ##|
|##             ###########          #######                ######        ###       ###          ##|
|####          ################     #########           ###########                ####          ##|
|######      #####################################  ###############                ###           ##|
|########     ####################################  ###############                ###           ##|
|#######                   ######              ###  ###          ####              ###           ##|
|#######                                                          ####      ##     ###           ##|
|#####                                                             ###      ##    ###            ##|
|####                                                              ####     ##    ###            ##|
|###      ##                                                       #####    ##    ###            ##|
|##     ####                             ##                         ####    ##    ####           ##|
|##  #########        ###               ####                        #####   ###   #########      ##|
|## #################### ##             ####                         ####   ###    #########     ##|
|####### #################       ####    ##                           ###   ##         #####     ##|
|######         ###########   #####                                    #                         ##|
|#####           ##########  #######                                                             ##|
|## #             ######### #########                                                            ##|
|####              ###########    ####                                                           ##|
|##                ##########       #####             #                                          ##|
|##                 ########         #######   ##### ##    ###   #                               ##|
|##                  #### ##          # ############# #   ##############       ####              ##|
|##                  #####           ############     #   ######     ############     #         ###|
|#                    ####            #              ##  ####         #  #   #####    #    ########|
|#                    ####            #              # #####           #  #     ##   ##    ########|
|#                    ###             #              ######               # #    #   ###  #####   #|
|#                    # #             #              #####                 ##    #   #### ####    #|
|#                                     #              ####               ###     ## ##### ####    #|
|#                                     #              ###                ###     ## # ########    #|
|#                                    ##              ###                 ##    #####   ######    #|
|#                                    ##              ##                   #     ####   ######    #|
|#           # ####        #          ##     ##########                    #     ###    ######    #|
|#          ##### ##       #          ##     #                             #     ###     #####    #|
|#          ####   #       #          #       #                            #    # ##     ####     #|
|#          ## #  ##       #          #       #                            #    # ###    ####     #|
|#          ####  ##       #          #       #                 # ##       #     ###     ####     #|
|#          ####  ##       #          #       #                #####       #      ##     ###      #|
|#          ####  ###      #          #       ########         #   ##      #      ##      ##      #|
|#          ###   ###      #          #              #        ###  ##      #      ##      ##      #|
|#          ###   ###      #          #              #        #    ##     ##                      #|
|#          ###   ###     ##          #              #       ##    ##     ##                      #|
|##         ###   ###     ##       # ##              #       ##    ##     ##                      #|
|##         ###   ###    ###         ##              #       ##    ##     ##                      #|
|##         ###   ###    ###         ##       ########       ##    #     ###                      #|
|##         ###   ###    ###         ##       #              ##   ##     ####                     #|
|##         ###   ###   ####         ##       #              ##   ##    #####                     #|
|###        ###   ###   ####        ###       #               # ###    ## ###                     #|
|###        ###   ###    ###        # #       #                ##     ##  ###         #           #|
|##         ###   ###    ###        # #       #######           #         ###        ###  #       #|
|##         ###   ###    ###         ##             ##                    ###        ####         #|
|###        ###    ##    ###         ##              ###                 ####        #####        #|
|###        ##     ##    ##          ##               ##                 ###        #######       #|
|####       ##     ##    ##          #               #####               ###        #######       #|
|####      ###     ##    ##          #               ##########         ####     ##########       #|
|#####   #####     ###   #############          ##   ############################# #########      #|
|##############    ################################################################################|
|--------------------------------------------------------------------------------------------------|
